S.##.....T
#T##..###.
#.###E###S
#.E...###.
###T#####G
