S.##.....T
#T##..###.
#.###E###E
#.E.T.###.
###T#####G
